2019-01-10
2019-02-10
2019-03-10
2019-04-10
2019-05-10
2019-06-10
2019-07-10
2019-08-10
2019-09-10
2019-10-10
